question	answer
1.1保险合同的构成	6.1请求给付保险金的诉讼时效
1.2投保年龄、年龄计算与错误的处理	6.2保险事故的通知
1.3合同的生效日	6.3保险金受益人的指定与变更
1.4保险期间	6.4如何申请保险金
1.5基本保险金额与申请减少基本保险金额	6.5保险金的给付时效
1.6明确说明与如实告知	6.6身体检查与司法鉴定
1.7本公司合同解除权的限制	6.7失踪处理
1.8犹豫期内的合同解除权	7欠款的扣除
2保障范围	
2.1保险责任	8保险合同的变更
2.2责任免除	8.1联系方式的变更8.2合同内容的变更
3保险费	
3.1保险费的缴纳	9合同效力的终止
3.2宽限期	
3.3保险费的自动垫缴	10争议的处理
4保单借款	11名词释义附表一：轻症疾病列表附表二：重大疾病列表中英人寿爱守护尊享版重大疾病保险
第1章您与我们的保险合同	
1.1保险合同的构成	我们与您订立的中英人寿爱守护尊享版重大疾病保险合同（以下简称本合同）由保险单、保险条款、所附的投保书及其它与本合同有关的投保文件、合法有效的声明、批注、批单及其它书面协议构成。
1.2投保年龄、年龄计算与错误的处理	本合同接受的被保险人投保年龄为0岁（出生满30天）至50周岁（见11.1）。被保险人的投保年龄，以有效身份证件登记的周岁年龄为准。您在申请投保时，应将与有效身份证件相符的被保险人的出生日期在投保书上填明，如果发生错误按照下列方式办理：1、您申报的被保险人年龄不真实，并且其真实年龄不符合本合同约定投保年龄限制的，我们有权解除合同，对于本合同解除前发生的保险事故，不承担赔偿或给付保险金的责任，但将退还本合同终止时的现金价值（见11.2）给您。我们行使合同解除权适用第1.7条的规定，我们不解除合同的按本条第2、3款办理。2、您申报的被保险人年龄不真实，致使您实付保险费少于应付保险费的，我们有权更正并要求您补缴保险费。若已经发生保险事故，我们按实付保险费和应付保险费的比例给付保险金。3、您申报的被保险人年龄不真实，致使您实付保险费多于应付保险费的，我们会将多收的保险费退还给您，本合同的基本保险金额不因此而改变。
1.3合同的生效日	本合同的生效日经我们同意承保，自您缴纳首期保险费当日的二十四时开始。我们将签发保险单作为承保的凭证。在我们签发保险单之前，如果您已缴纳首期保险费，且您已履行如实告知义务并符合我们的承保条件，则本合同的生效日将追溯至您缴纳首期保险费当日二十四时开始。本合同的生效日以保险单所载的日期为准。保单周年日（见11.3）、保单年度（见11.4）、保单满期日和保险费到期日（见11.5）均以该日期为基准计算。本合同生效后，我们将依照第2.1条的约定开始承担保险责任。
1.4保险期间	本合同提供终身保障，保险期间自合同生效日起，至合同约定终止时止。
1.5基本保险金额与申请减少基本保险金额	本合同的基本保险金额由您和我们约定并在保险单上载明。如果该基本保险金额有所变更，以变更后的金额为准。在本合同有效期内，您可以书面申请减少基本保险金额，但减少后的基本保险金额，须符合您申请时我们规定的最低承保金额。基本保险金额的减少部分视为终止合同，我们将退还基本保险金额减少部分所对应的现金价值。您为您未成年子女投保的人身保险，因被保险人身故给付的保险金总和不得超过国务院保险监督管理机构规定的限额，身故给付的基本保险金额总和约定也不得超过前述限额。
1.6明确说明与如实告知	订立本合同时，我们应向您说明本合同的内容。对保险条款中免除我们责任的条款，我们在订立合同时应当在投保书、保险单或其它保险凭证上作出足以引起您注意的提示，并对该条款的内容以书面或口头形式向您作出明确说明，未作提示或明确说明的，该条款不产生效力。我们就您和被保险人的有关情况提出询问，您应当如实告知。如果您故意或因重大过失未履行前款规定的如实告知义务，足以影响我们决定是否同意承保或提高保险费率的，我们有权解除本合同。如果您故意不履行如实告知义务，对于本合同解除前发生的保险事故，我们不承担给付保险金的责任，并不退还保险费。如果您因重大过失未履行如实告知义务，对保险事故的发生有严重影响的，对于本合同解除前发生的保险事故，我们不承担给付保险金的责任，但应当退还保险费。我们在合同订立时已经知道您未如实告知的情况的，我们不得解除合同；发生保险事故的，我们按本合同约定承担保险责任。
1.7本公司合同解除权的限制	前条规定的合同解除权，自我们知道有解除事由之日起，超过30日不行使而消灭。自本合同成立之日起超过二年的，我们不得解除合同；发生保险事故的，我们按本合同约定承担保险责任。
1.8犹豫期内的合同解除权	自您签收本合同之日起，有10天（含）的犹豫期。在此期间，请您认真阅读本合同，如果您认为本合同与您的需求不相符，您可以在此期间解除本合同，我们将无息退还您所缴纳的保险费。解除本合同时，您需要填写申请书，并提供您的保险合同及有效身份证件。自我们收到您解除合同的书面申请时起，本合同即被解除，合同解除前发生的保险事故我们不承担保险责任。
第2章保障范围	
2.1保险责任	在本合同有效期内，我们按照以下约定承担保险责任：自本合同生效日（或最后复效日）起90天内（含第90天）的期间为等待期。如果被保险人在等待期内发生或确诊患本合同附表一所列任何一种轻症疾病（见11.6）或附表二所列任何一种重大疾病（见11.7），我们将无息退回您已缴纳的本合同的保险费，同时本合同终止。但如果被保险人因意外伤害事故（见11.8）导致患本合同附表一所列任何一种轻症疾病或附表二所列任何一种重大疾病，则无等待期。1、轻症疾病保险金在等待期后，按本合同附表一对轻症疾病（见11.6）的定义和诊断标准，如果被保险人初次发生并被专科医生（见11.9）确诊患本合同附表一所列任何一种轻症疾病，并且在轻症疾病确诊前未被确诊患本合同附表二所列任何一种重大疾病，我们将按本合同基本保险金额的20给付轻症疾病保险金。同一种轻症疾病仅给付一次轻症疾病保险金，轻症疾病保险金最多给付两次，轻症疾病保险金给付满两次后，本项保险责任终止。如果被保险人因同一意外伤害事故或相同疾病导致其确诊患本合同附表一所列任何两种或两种以上的轻症疾病，且两次轻症疾病的确诊之日相距不超过180天（含第180天），我们仅按一种轻症疾病给付一次轻症疾病保险金。2、重大疾病保险金在等待期后，按本合同附表二对重大疾病（见11.7）的定义和诊断标准，如果被保险人初次发生并被专科医生确诊患本合同附表二所列任何一种重大疾病，我们将按本合同基本保险金额给付重大疾病保险金。当我们第一次给付重大疾病保险金后，本合同轻症疾病保险金和身故保险金的保险责任同时终止，我们不再承担给付轻症疾病保险金和身故保险金的保险责任，本合同的现金价值降低为零。同一种重大疾病仅给付一次重大疾病保险金，重大疾病保险金最多给付两次，且两次重大疾病的确诊之日相距需大于365天。重大疾病保险金给付满两次后，本合同终止。如果被保险人确诊重大疾病时，同时符合轻症疾病的定义，我们仅支付重大疾病保险金，不再支付轻症疾病保险金。如果被保险人在申请重大疾病保险金前已经申请并获得轻症疾病保险金的，且该轻症疾病的确诊发生在被保险人符合重大疾病保险金给付条件之后，则我们在给付重大疾病保险金时，将把已经给付的轻症疾病保险金扣除。3、恶性肿瘤关爱保险金在等待期后，如果被保险人在年满80周岁前（含80周岁生日当天），初次发生并被专科医生确诊患恶性肿瘤（见11.10），我们将在给付重大疾病保险金的同时，再按本合同基本保险金额的20给付恶性肿瘤关爱保险金，同时本项保险责任终止。恶性肿瘤关爱保险金的给付以一次为限。如果被保险人按本合同附表二对重大疾病的定义和诊断标准，在确诊患第一次重大疾病（不包含恶性肿瘤）之日起365天内（含第365天），初次发生并被专科医生确诊患恶性肿瘤，则我们不予给付恶性肿瘤关爱保险金。4、身故保险金如果被保险人在年满18周岁前（不含18周岁生日当天）身故，我们将按您已经缴纳的本合同的全部保险费给付身故保险金，同时本合同终止。本合同的全部保险费是指保险事故发生时本合同基本保险金额所对应的已缴保险费，其中包含依照本合同第3.3条以保险费自动垫缴方式垫缴的保险费和豁免疾病确诊日后至保险合同终止日期间已实际豁免的各期保险费。如果被保险人在年满18周岁后（含18周岁生日当天）身故，我们将按本合同基本保险金额给付身故保险金，同时本合同终止。对于本合同的重大疾病保险金和身故保险金，我们仅给付一项。5、豁免保费在等待期后，按本合同附表一对轻症疾病或附表二对重大疾病的定义和诊断标准，如果被保险人初次发生并被专科医生确诊患本合同附表一所列任何一种轻症疾病或附表二所列任何一种重大疾病，我们将豁免疾病确诊日后本合同保险期间内的各期保险费。我们豁免保险费后，您不得再办理本合同基本保险金额的变更。
2.2责任免除	如果由于以下任何一种情形，导致被保险人身故、或患本合同附表一所列任何一种轻症疾病，或患本合同附表二所列任何一种重大疾病，我们不承担保险责任，同时本合同终止：1、投保人对被保险人的故意杀害、故意伤害；2、被保险人故意犯罪或抗拒依法采取的刑事强制措施；3、被保险人自伤，或自合同生效日起二年内或最后复效日起二年内（以较迟者为准）自杀，但被保险人自杀时为无民事行为能力人的除外；4、被保险人主动吸食或注射毒品（见11.11）；5、被保险人酒后驾驶（见11.12），无合法有效驾驶证驾驶（见11.13），或驾驶无有效行驶证（见11.14）的机动车；6、战争、军事冲突、暴乱或武装叛乱；7、核爆炸、核辐射或核污染；8、被保险人感染艾滋病病毒（HIV）或患艾滋病（AIDS）（见11.15）（因本合同附表二所列第32项、第33项和第80项所导致的除外）；9、遗传性疾病（见11.16），先天性畸形、变形或染色体异常（见11.17）。发生上述第1种情形导致本合同终止的，如果您已缴足二年保险费，我们将退还本合同终止时的现金价值给被保险人；如果被保险人身故的，该现金价值将作为被保险人的遗产处理。发生上述第2种情形导致本合同终止的，如果您已缴足二年保险费，我们将退还本合同终止时的现金价值给您。发生上述第3种至第9种情形导致本合同终止的，我们将退还本合同终止时的现金价值给您。
第3章保险费	
3.1保险费的缴纳	本合同的保险费金额、缴费期间和缴费方式将在保险单上载明。保险费按照我们核定的保险费率计算，根据您与我们约定的基本保险金额确定。您应于保险费到期日或之前向我们缴纳保险费。
3.2宽限期	如果您没有按期缴纳保险费，自保险费到期日次日零时起60天为我们给予您的宽限期。宽限期内，您的保险合同继续有效，如果发生保险事故，我们仍按本合同约定承担保险责任，但在给付保险金时会扣减您欠缴的保险费。除本合同其它条款另有约定外，如果宽限期结束后您仍未缴纳保险费，本合同自宽限期满当日二十四时起效力中止。
3.3保险费的自动垫缴	当宽限期结束后您仍未缴纳到期保险费时，如果本合同当时的现金价值扣除您尚未偿清的保单借款本金和利息（见11.18）之后，足以垫付本合同及其附加合同当期欠缴的保险费，我们将按保单借款的方式自动借款给您，用来支付保险费，本合同及其附加合同继续有效。如果本合同当时的现金价值扣除您尚未偿清的保单借款本金和利息之后，不足以垫付本合同及其附加合同当期欠缴的保险费，本合同及其附加合同的效力将中止。
第4章保单借款	在本合同有效期内，经被保险人书面同意，您可以书面形式向我们申请借款。每次借款期限一般不超过六个月，申请借款时累计借款金额本金和利息最高不得超过本合同当时现金价值的80（因垫缴到期保险费则不受此限）。我们将对您的保单借款通过年复利方式进行计息：我们将于每月第一个营业日公布借款利率，该借款利率不会超过当时中国人民银行六个月贷款利率上浮0.25。您应于每个保单周年日前缴纳借款利息，至借款金额全部偿清时止；若逾期未付，则所有应付而未付的利息将并入借款金额中计算利息。若您尚未偿清的保单借款本金及利息等于或超过本合同的现金价值，本合同效力中止。
第5章合同效力的中止和恢复（下称复效）	在本合同效力中止期间，我们不承担保险责任。本合同效力中止二年内，您可以书面申请恢复合同效力。经我们与您协商并达成协议，并且您已偿清保单借款、自动垫缴的保险费等款项的本金和利息以及您欠缴的保险费，我们将出具批单或在本合同上进行批注，本合同从我们同意您的复效申请当日二十四时起恢复效力，此日期我们将在批单或批注上载明。自本合同效力中止之日起满二年您和我们未达成协议的，我们有权解除合同。我们解除合同的，将向您退还合同效力中止时本合同的现金价值。
第6章保险金的给付	
6.1请求给付保险金的诉讼时效	本合同受益人向我们请求给付保险金的诉讼时效期间为二年，自其知道或应当知道保险事故发生之日起计算。
6.2保险事故的通知	您或保险金受益人应在知道保险事故发生之日起10个工作日内通知我们，如果您或受益人故意或因重大过失未及时通知，致使保险事故的性质、原因、损失程度等难以确定的，我们对无法确定的部分，不承担给付保险金的责任，但我们通过其它途径已经及时知道或应当及时知道保险事故发生或虽未及时通知但不影响我们确定保险事故的性质、原因、损失程度的除外。
6.3保险金受益人的指定与变更	除另有指定外，本合同轻症疾病保险金、重大疾病保险金和恶性肿瘤关爱保险金的受益人是被保险人本人。您或被保险人可以指定一人或多人为身故保险金受益人。身故保险金受益人为多人时，可以确定受益顺序和受益份额；如果没有确定份额，各受益人按照相等份额享有受益权。被保险人为无民事行为能力人或限制民事行为能力人的，可以由其监护人指定受益人。您或被保险人可以变更身故保险金受益人并书面通知我们。我们收到变更受益人的书面通知后，在保险单或其它保险凭证上批注或附贴批单。您在指定和变更身故保险金受益人时，必须经过被保险人同意。被保险人身故后，有下列情形之一的，保险金作为被保险人的遗产，由我们依照中华人民共和国继承法的规定履行给付保险金的义务：1、没有指定受益人，或受益人指定不明无法确定的；2、受益人先于被保险人身故，没有其他受益人的；3、受益人依法丧失受益权或放弃受益权，没有其他受益人的。受益人与被保险人在同一事件中身故，且不能确定身故先后顺序的，推定受益人身故在先。受益人故意造成被保险人身故、伤残、疾病的，或故意杀害被保险人未遂的，该受益人丧失受益权。
6.4如何申请保险金	1、申请轻症疾病保险金、重大疾病保险金、恶性肿瘤关爱保险金或豁免保费时，申请人须填写理赔申请书，并提供下列证明和资料原件：（1）保险合同；（2）被保险人的有效身份证件；（3）医院（见11.19）诊断证明（包括完整的门诊病历、出院小结或出院证明、相关的检查检验报告等）；（4）本合同附表一所列相应轻症疾病和附表二所列相应重大疾病中明确要求的其它医疗证明；（5）所能提供的与确认保险事故的性质、原因等有关的其它证明和资料。2、申请身故保险金时，申请人须填写理赔申请书，并提供下列证明和资料原件：（1）保险合同；（2）身故保险金受益人的有效身份证件，与被保险人的关系证明；（3）被保险人的有效身份证件，户籍注销证明；（4）国家卫生行政部门认定的医疗机构、公安部门或其它相关机构出具的被保险人的死亡证明或人民法院出具的宣告死亡证明文件；（5）所能提供的与确认保险事故的性质、原因等有关的其它证明和资料。保险金作为被保险人遗产时，申请人必须提供可证明合法继承权的相关权利文件。以上证明和资料不完整的，我们将及时一次性通知申请人补充提供有关证明和资料。
6.5保险金的给付时效	我们在收到理赔申请书及合同约定的证明和资料后，会及时作出核定；情形复杂的，在30日内作出核定。对属于保险责任的，我们在与受益人达成给付保险金的协议后10日内，履行给付保险金义务。我们未及时履行前款规定义务的，除支付保险金外，应当赔偿受益人因此受到的损失。对不属于保险责任的，我们自作出核定之日起3日内向受益人发出拒绝给付保险金通知书并说明理由。我们在收到理赔申请书及有关证明和资料之日起60日内，对给付保险金的数额不能确定的，根据已有证明和资料可以确定的数额先予支付；我们最终确定给付保险金的数额后，将支付相应的差额。
6.6身体检查与司法鉴定	申请保险金时，我们有权要求被保险人在我们指定的机构做身体检查及鉴定。申请身故保险金时，我们有权通过司法鉴定机构对保险事故进行鉴定。
6.7失踪处理	被保险人在本合同有效期内失踪，而且被法院宣告死亡，我们以判决书所确定的身故日为准，按照本合同的约定给付身故保险金；如果您或身故保险金受益人能提供证明文件，足以证明被保险人因意外伤害事故身故的，我们将以意外伤害事故发生日为准，按照本合同约定给付身故保险金。如果领取我们因被保险人身故而给付的保险金后，发现被保险人仍然生存，保险金领取人必须于知道被保险人仍然生存之日起一个月内将我们因被保险人身故而给付的保险金归还我们，在被保险人失踪期间，如果有其它应给付的保险金的，我们将依约给付。
第7章欠款的扣除	我们在给付保险金、退还本合同现金价值或保险费时，如果您有任何尚未偿清的保单借款、自动垫缴的保险费等款项的本金和利息或欠缴的保险费，我们有权先行扣除上述欠款。
第8章保险合同的变更	
8.1联系方式的变更	您的联系方式（包括住所、通讯地址、联系电话、电子邮箱等）变更时，应及时通知我们。如果您没有及时通知我们，我们按所知的最后联系方式所发送的通知，均视为已经送达。如果因您未能及时通知我们，而使我们无法提供给您相应的服务，我们将不承担责任。
8.2合同内容的变更	在本合同有效期内，您可以书面形式向我们申请变更本合同的有关内容。该项变更须符合我们的规定，经我们审核同意并在本合同上批注或出具批单或与您订立书面变更协议后生效。若被保险人身故，则我们不接受本合同任何内容的变更申请。
第9章合同效力的终止	发生下列任何一种情形时，本合同终止：1、投保人解除合同。如果您在犹豫期后申请解除本合同，请填写解除合同申请书并向我们提供下列资料：（1）保险合同（2）投保人的有效身份证件自我们收到解除合同申请书时起，本合同终止。我们自收到解除合同申请书之日起30日内按合同约定向您退还本合同终止时的现金价值。您在犹豫期后解除合同可能会遭受一定损失；2、因本合同其它条款或其附加合同条款所列情况终止。
争议的处理	
第10章	在本合同履行过程中发生任何争议，双方应首先通过协商解决。若双方协商无效的，可依法向人民法院提出诉讼。
名词释义	
第11章	
11.1周岁：	指按有效身份证件中记载的出生日期计算的年龄，自出生之日起为零周岁，每经过一年增加一岁，不足一年的不计。
11.2现金价值：	指本合同所具有的价值，通常体现为解除合同时，根据精算原理计算的，由我们退还的那部分金额。我们会在保险单或批注上载明本合同保单年度末的现金价值。
11.3保单周年日：	指本合同生效日在以后每年的对应日，如果当年无对应的同一日，则以合同生效日所在月份最后一日为对应日。
11.4保单年度：	从本合同生效日或以后每一年之对应日二十四时起，至下一年度合同生效日之对应日二十四时止，为一个保单年度，如果当年无对应的同一日，则以合同生效日所在月份最后一日为对应日。应日，如果当月无对应的同一日，则以该月最后一日为对应日。
11.6轻症疾病：	指符合本合同附表一中所列的任何一种疾病定义所述条件的疾病。
11.7重大疾病：	指符合本合同附表二中所列的任何一种疾病定义所述条件的疾病。伤害的客观事件。
11.9专科医生：	专科医生应当同时满足以下四项资格条件：（1）具有有效的中华人民共和国医师资格证书；（2）具有有效的中华人民共和国医师执业证书，并按期到相关部门登记注册；（3）具有有效的中华人民共和国主治医师或主治医师以上职称的医师职称证书；（4）在二级或二级以上医院的相应科室从事临床工作三年以上。
11.10恶性肿瘤：	指恶性细胞不受控制的进行性增长和扩散，浸润和破坏周围正常组织，可以经血管、淋巴管和体腔扩散转移到身体其它部位的疾病。经病理学检查结果确诊，临床诊断属于世界卫生组织疾病和有关健康问题的国际统计分类（ICD10）的恶性肿瘤范畴。下列疾病不在保障范围内：（1）原位癌；（2）相当于Binet分期方案A期程度的慢性淋巴细胞白血病；（3）相当于AnnArbor分期方案I期程度的何杰金氏病；（4）皮肤癌（不包括恶性黑色素瘤及已发生转移的皮肤癌）；（5）TNM分期为T1N0M0期或更轻分期的前列腺癌；（6）感染艾滋病病毒或患艾滋病期间所患恶性肿瘤。
11.11毒品：	指中华人民共和国刑法规定的鸦片、海洛因、甲基苯丙胺（冰毒）、吗啡、大麻、可卡因以及国家规定管制的其它能够使人形成瘾癖的麻醉药品和精神药品，但不包括由医生开具并遵医嘱使用的用于治疗疾病但含有毒品成分的处方药品。
11.12酒后驾驶：	指经检测或鉴定，发生事故时车辆驾驶人员每百毫升血液中的酒精含量达到或超过一定的标准，公安机关交通管理部门依据中华人民共和国道路交通安全法的规定认定为饮酒后驾驶或醉酒后驾驶。
11.13无合法有效驾驶证驾驶：	指下列情形之一：1、没有取得驾驶资格；2、驾驶与驾驶证准驾车型不相符合的车辆；3、持审验不合格的驾驶证驾驶；4、持学习驾驶证学习驾车时，无教练员随车指导，或不按指定时间、路线学习驾车。
11.14无有效行驶证：指下列情形之一：	1、机动车被依法注销登记的；2、未依法按时进行或通过机动车安全技术检验。
11.15感染艾滋病病毒（HIV）或患艾滋病（AIDS）：	艾滋病病毒指人类免疫缺陷病毒，英文缩写为HIV。艾滋病指人类免疫缺陷病毒引起的获得性免疫缺陷综合征，英文缩写为AIDS。在人体血液或其它样本中检测到艾滋病病毒或其抗体呈阳性，没有出现临床症状或体征的，为感染艾滋病病毒；如果同时出现了明显临床症状或体征的，为患艾滋病。
11.16遗传性疾病：	指生殖细胞或受精卵的遗传物质（染色体和基因）发生突变或畸变所引起的疾病，通常具有由亲代传至后代的垂直传递的特征。
11.17先天性畸形、变形或染色体异常：	指被保险人出生时就具有的畸形、变形或染色体异常。先天性畸形、变形和染色体异常依照世界卫生组织疾病和有关健康问题的国际统计分类（ICD10）确定。
11.18利息：	指保单借款和自动垫缴的保险费等欠款所产生的利息，该利息按第4章保单借款规定的保单借款利率计算。
11.19医院：	指我们指定的医院或经中华人民共和国卫生部门评审确定的二级或以上的公立医院，但不包括精神病院及专供康复、护理、疗养、戒酒、戒毒、养老等非以直接诊治病人为目的之医疗机构。该医院必须具有符合国家有关医院管理规则设置标准的医疗设备，且全天二十四小时有合格的医生和护士驻院提供医疗和护理服务。当被保险人因遭遇意外伤害事故须急救时不受此限，但经急救处理伤情稳定后，必须及时转入本合同所指医院治疗。医生是指领有执业医师执照、在医院内行医并拥有处方权的医生，且非您或被保险人以及您或被保险人的配偶、父母、子女。
11.20永久不可逆：	指自疾病确诊或意外伤害发生之日起，经过积极治疗180天后，仍无法通过现有医疗手段恢复。
11.21六项基本日常生活活动：	六项基本日常生活活动是指：（1）穿衣：自己能够穿衣及脱衣；（2）移动：自己从一个房间到另一个房间；（3）行动：自己上下床或上下轮椅；（4）如厕：自己控制进行大小便；（5）进食：自己从已准备好的碗或碟中取食物放入口中；（6）洗澡：自己进行淋浴或盆浴。
11.22肢体机能完全丧失：	指肢体的三大关节中的两大关节僵硬，或不能随意识活动。肢体是指包括肩关节的整个上肢或包括髋关节的整个下肢。
11.23语言能力完全丧失：	指无法发出四种语音（包括口唇音、齿舌音、口盖音和喉头音）中的任何三种、或声带全部切除，或因大脑语言中枢受伤害而患失语症。
11.24咀嚼吞咽能力完全丧失：	指因牙齿以外的原因导致器质障碍或机能障碍，以致不能作咀嚼吞咽运动，除流质食物外不能摄取或吞咽的状态。
附表一：轻症疾病列表	包括以下疾病、疾病状态或手术。
1.极早期的恶性肿瘤或恶性病变	指经组织病理学检查被明确诊断为下列恶性病变，并且接受了相应的治疗。（1）原位癌；（2）相当于Binet分期方案A期程度的慢性淋巴细胞白血病；（3）相当于AnnArbor分期方案I期程度的何杰金氏病；（4）皮肤癌（不包括恶性黑色素瘤及已发生转移的皮肤癌）；（5）TNM分期为T1N0M0期或更轻分期的前列腺癌。原位癌指恶性细胞局限于上皮内尚未穿破基底膜浸润周围正常组织的癌细胞新生物。原位癌必须经对固定活组织的组织病理学检查确诊。被保险人必须已经接受了针对原位癌病灶的积极治疗。
2.不典型的急性心肌梗塞	指被临床诊断为急性心肌梗塞并接受了急性心肌梗塞治疗，虽然未达到重大疾病急性心肌梗塞的给付标准，但满足下列全部条件：（1）肌钙蛋白有诊断意义的升高；（2）心电图有损伤性的ST段改变但未出现病理Q波。
3.轻微脑中风	指实际发生了脑血管的突发病变出现神经系统功能障碍表现，头颅断层扫描（CT）、核磁共振（MRI）等影像学检查证实存在对应病灶，确诊为脑出血、脑栓塞或脑梗塞，在确诊180天后未遗留神经系统功能障碍或后遗的神经系统功能障碍程度未达到重大疾病脑中风后遗症的给付标准。短暂性脑缺血发作（TIA）和腔隙性脑梗塞不在保障范围内。
4.心脏瓣膜介入手术	为了治疗心脏瓣膜疾病，实际实施了非开胸的经胸壁打孔内镜手术或经皮经导管介入手术进行的心脏瓣膜置换或修复手术。未达到重大疾病双目失明的给付标准，但满足下列全部条件：（1）双眼中较好眼矫正视力低于0.1（采用国际标准视力表，如果使用其他视力表应进行换算）；（2）视野半径小于20度。申请理赔时，被保险人年龄必须在3周岁以上，并且须提供理赔当时的视力丧失诊断及检查证据。
6.较小面积度烧伤	指烧伤程度为度，且度烧伤的面积达到全身体表面积的15或15以上。体表面积根据中国新九分法计算。主动脉指胸主动脉和腹主动脉，不包括胸主动脉和腹主动脉的分支血管。
8.脑垂体瘤、脑囊肿、脑动脉瘤及脑血管瘤	指经头颅断层扫描（CT）、核磁共振检查（MRI）或其他影像学检查被确诊为下列病变，并实际接受了手术或放射治疗。（1）脑垂体瘤；（2）脑囊肿；（3）脑动脉瘤、脑血管瘤。功能障碍。须由头颅断层扫描（CT）、核磁共振检查（MRI）或正电子发射断层扫描（PET）等影像学检查证实。神经系统永久性的功能障碍，指脑损伤180天后，仍完全丧失自主生活能力，无法独立完成六项基本日常生活活动（见11.21）中的二项或以上。
10.单个肢体缺失	指因疾病或意外伤害导致一个肢体自腕关节或踝关节近端（靠近躯干端）以上完全性断离。
11.特定周围动脉狭窄的血管介入治疗	指为治疗特定周围动脉的狭窄而实际实施的血管成形术、支架植入术或动脉粥样硬化斑块清除手术。诊断及治疗均须在医院内由专科医师认为是医疗必须的情况下进行，并须经血管造影术证实接受介入治疗的动脉有50或以上的狭窄。特定周围动脉指肾动脉、肠系膜动脉和为下肢或上肢供血的动脉。
12.严重脑炎或脑膜炎	指因患脑炎或脑膜炎住院治疗，并且导致神经系统永久性的功能障碍。神经系统永久性的功能障碍，指疾病确诊180天后，仍遗留下列一种或一种以上障碍：（1）一肢或一肢以上肢体肌力级或级以下的运动功能障碍；（2）听力丧失，双耳平均听阈大于55分贝或一耳平均听阈大于90分贝；（3）视野缺损，双眼视野半径小于20度；（4）视力严重受损，双眼中较好眼矫正视力低于0.1（采用国际标准视力表，如果使用其他视力表应进行换算）。
13.可逆性再生障碍性贫血	指因急性可逆性的骨髓造血功能衰竭而导致贫血、中性粒细胞减少和血小板减少，必须由血液科医生的诊断，且病历资料显示接受了下列任一治疗：（1）骨髓刺激疗法至少1个月；（2）免疫抑制剂治疗至少1个月。
14.人工耳蜗植入手术	指由于耳蜗的永久损害而实际实施了人工耳蜗植入手术。手术需经专科医生确认在医学上是必要的，且在植入手术之前已经符合以下全部条件：（1）双耳持续12个月以上重度感音神经性耳聋；（2）使用相应的听力辅助设备效果不佳。
15.单侧肺脏切除	因疾病或意外事故实际实施的一侧肺脏切除术，部分切除手术和肺脏捐献引起的手术不在保障范围内。
16.早期肝硬化	肝硬化须由专科医生明确诊断。必须由活检证实有再生的肝细胞结节和典型的肝组织纤维化。以下条件必须全部满足并至少持续一年：（1）持续性黄疸，胆红素水平升高超过50mol/L;（2）蛋白质合成异常，白蛋白水平低于27g/L;（3）异常凝血功能，凝血酶原时间超过正常上限的2倍或以上，或者国际正常化比率（INR）在2.0以上。继发于酒精、毒品或药物滥用的肝硬化不在保障范围内。
17.肝脏切除	指因疾病或意外事故实际实施的肝脏部分切除术，手术须有至少一个完整的肝叶切除。因酗酒导致的肝脏损伤不在保障范围内。
18.腔静脉过滤器植入术	指经医院的专科医生证明有反复肺栓塞发作及抗凝治疗无效而必须接受手术植入腔静脉过滤器。理赔时需提供完整病历及手术记录以证明植入腔静脉过滤器有必要性及已确实施行了手术。
19.肺间质纤维化病	指诊断为间质性肺纤维化的肺病，并需要接受间歇性氧气治疗及在接受适当的药物治疗下的第一秒末用力呼气量(FEV1)小于1.2升。诊断、严重程度及测试结果必须由专科医生确定。
20.深度昏迷72小时	指因疾病或意外伤害导致意识丧失,对外界刺激和体内需求均无反应,昏迷程度按照格拉斯哥昏迷分级（Glasgowcomascale）结果为5分或5分以下，且已经持续使用呼吸机及其它生命维持系统72小时以上。因酗酒或药物滥用导致的深度昏迷不在保障范围内。
附表二：重大疾病列表	包括以下疾病、疾病状态或手术。其中第125项为中国保险行业协会与中国医师协会共同制定的疾病定义，第2680项为我们增加的疾病种类并自行制定的疾病定义。
1.恶性肿瘤	指恶性细胞不受控制的进行性增长和扩散，浸润和破坏周围正常组织，可以经血管、淋巴管和体腔扩散转移到身体其它部位的疾病。经病理学检查结果确诊，临床诊断属于世界卫生组织疾病和有关健康问题的国际统计分类（ICD10）的恶性肿瘤范畴。下列疾病不在保障范围内：（1）原位癌；（2）相当于Binet分期方案A期程度的慢性淋巴细胞白血病；（3）相当于AnnArbor分期方案I期程度的何杰金氏病；（4）皮肤癌（不包括恶性黑色素瘤及已发生转移的皮肤癌）；（5）TNM分期为T1N0M0期或更轻分期的前列腺癌；（6）感染艾滋病病毒或患艾滋病期间所患恶性肿瘤。
2.急性心肌梗塞	指因冠状动脉阻塞导致的相应区域供血不足造成部分心肌坏死。须满足下列至少三项条件：（1）典型临床表现，例如急性胸痛等；（2）新近的心电图改变提示急性心肌梗塞；（3）心肌酶或肌钙蛋白有诊断意义的升高，或呈符合急性心肌梗塞的动态性变化；（4）发病90天后，经检查证实左心室功能降低，如左心室射血分数低于50。
3.脑中风后遗症	指因脑血管的突发病变引起脑血管出血、栓塞或梗塞，并导致神经系统永久性的功能障碍。神经系统永久性的功能障碍，指疾病确诊180天后，仍遗留下列一种或一种以上障碍：（1）一肢或一肢以上肢体机能完全丧失（见11.22）；（2）语言能力完全丧失（见11.23）或咀嚼吞咽能力完全丧失（见11.24）；（3）自主生活能力完全丧失，无法独立完成六项基本日常生活活动中的三项或三项以上。
4.重大器官移植术或造血干细胞移植术	重大器官移植术，指因相应器官功能衰竭，已经实施了肾脏、肝脏、心脏或肺脏的异体移植手术。造血干细胞移植术，指因造血功能损害或造血系统恶性肿瘤，已经实施了造血干细胞（包括骨髓造血干细胞、外周血造血干细胞和脐血造血干细胞）的异体移植手术。
5.冠状动脉搭桥术（或称冠状动脉旁路移植术）	指为治疗严重的冠心病，实际实施了开胸进行的冠状动脉血管旁路移植的手术。冠状动脉支架植入术、心导管球囊扩张术、激光射频技术及其它非开胸的介入手术、腔镜手术不在保障范围内。
6.终末期肾病（或称慢性肾功能衰竭尿毒症期）	指双肾功能慢性不可逆性衰竭，达到尿毒症期，经诊断后已经进行了至少90天的规律性透析治疗或实施了肾脏移植手术。
7.多个肢体缺失	指因疾病或意外伤害导致两个或两个以上肢体自腕关节或踝关节近端（靠近躯干端）以上完全性断离。
8.急性或亚急性重症肝炎	指因肝炎病毒感染引起肝脏组织弥漫性坏死，导致急性肝功能衰竭，且经血清学或病毒学检查证实，并须满足下列全部条件：（1）重度黄疸或黄疸迅速加重；（2）肝性脑病；（3）B超或其它影像学检查显示肝脏体积急速萎缩；（4）肝功能指标进行性恶化。
9.良性脑肿瘤	指脑的良性肿瘤，已经引起颅内压增高，临床表现为视神经乳头水肿、精神症状、癫痫及运动感觉障碍等，并危及生命。须由头颅断层扫描（CT）、核磁共振检查（MRI）或正电子发射断层扫描（PET）等影像学检查证实，并须满足下列至少一项条件：（1）实际实施了开颅进行的脑肿瘤完全切除或部分切除的手术；（2）实际实施了对脑肿瘤进行的放射治疗。脑垂体瘤、脑囊肿、脑血管性疾病不在保障范围内。
10.慢性肝功能衰竭失代偿期	指因慢性肝脏疾病导致肝功能衰竭，须满足下列全部条件：（1）持续性黄疸；（2）腹水；（3）肝性脑病；（4）充血性脾大伴脾功能亢进或食管胃底静脉曲张。因酗酒或药物滥用导致的肝功能衰竭不在保障范围内。
11.脑炎后遗症或脑膜炎后遗症	指因患脑炎或脑膜炎导致的神经系统永久性的功能障碍。神经系统永久性的功能障碍，指疾病确诊180天后，仍遗留下列一种或一种以上障碍：（1）一肢或一肢以上肢体机能完全丧失；（2）语言能力或咀嚼吞咽能力完全丧失；（3）自主生活能力完全丧失，无法独立完成六项基本日常生活活动中的三项或三项以上。
12.深度昏迷	指因疾病或意外伤害导致意识丧失，对外界刺激和体内需求均无反应，昏迷程度按照格拉斯哥昏迷分级（Glasgowcomascale）结果为5分或5分以下，且已经持续使用呼吸机及其它生命维持系统96小时以上。因酗酒或药物滥用导致的深度昏迷不在保障范围内。
13.双耳失聪	指因疾病或意外伤害导致双耳听力永久不可逆性丧失，在500赫兹、1000赫兹和2000赫兹语音频率下，平均听阈大于90分贝，且经纯音听力测试、声导抗检测或听觉诱发电位检测等证实。申请理赔时被保险人年龄必须在3周岁以上，并且提供理赔当时的听力丧失诊断及检查证明。
14.双目失明	指因疾病或意外伤害导致双目视力永久不可逆性丧失，双眼中较好眼须满足下列至少一项条件：（1）眼球缺失或摘除；（2）矫正视力低于0.02（采用国际标准视力表，如果使用其它视力表应进行换算）；（3）视野半径小于5度。申请理赔时被保险人年龄必须在3周岁以上，并且提供理赔当时的视力丧失诊断及检查证明。
15.瘫痪	指因疾病或意外伤害导致两肢或两肢以上的肢体机能永久完全丧失。肢体机能永久完全丧失，指疾病确诊180天后或意外伤害事故发生180天后，每肢三大关节中的两大关节仍然完全僵硬，或不能随意识活动。
16.心脏瓣膜手术	指为治疗心脏瓣膜疾病，实际实施了开胸进行的心脏瓣膜置换或修复的手术。
17.严重阿尔茨海默病	指因大脑进行性、不可逆性改变导致智能严重衰退或丧失，临床表现为明显的认知能力障碍、行为异常和社交能力减退，其日常生活必须持续受到他人监护。须由头颅断层扫描（CT）、核磁共振检查（MRI）或正电子发射断层扫描（PET）等影像学检查证实，且自主生活能力完全丧失，无法独立完成六项基本日常生活活动中的三项或三项以上。神经官能症和精神病不在保障范围内。
18.严重脑损伤	指因头部遭受机械性外力，引起脑重要部位损伤，导致神经系统永久性的功能障碍。须由头颅断层扫描（CT）、核磁共振检查（MRI）或正电子发射断层扫描（PET）等影像学检查证实。神经系统永久性的功能障碍，指脑损伤180天后，仍遗留下列一种或一种以上障碍：（1）一肢或一肢以上肢体机能完全丧失；（2）语言能力或咀嚼吞咽能力完全丧失；（3）自主生活能力完全丧失，无法独立完成六项基本日常生活活动中的三项或三项以上。
19.严重帕金森病	是一种中枢神经系统的退行性疾病，临床表现为震颤麻痹、共济失调等。须满足下列全部条件：（1）药物治疗无法控制病情；（2）自主生活能力完全丧失，无法独立完成六项基本日常生活活动中的三项或三项以上。继发性帕金森综合症不在保障范围内。
20.严重度烧伤	指烧伤程度为度，且度烧伤的面积达到全身体表面积的20或20以上。体表面积根据中国新九分法计算。
21.严重原发性肺动脉高压	指不明原因的肺动脉压力持续性增高，进行性发展而导致的慢性疾病，已经造成永久不可逆性的体力活动能力受限，达到美国纽约心脏病学会心功能状态分级级，且静息状态下肺动脉平均压超过30mmHg。
22.严重运动神经元病	指一组中枢神经系统运动神经元的进行性变性疾病，包括进行性脊肌萎缩症、进行性延髓麻痹症、原发性侧索硬化症、肌萎缩性侧索硬化症。须满足自主生活能力完全丧失，无法独立完成六项基本日常生活活动中的三项或三项以上的条件。
23.语言能力丧失	指因疾病或意外伤害导致完全丧失语言能力，经过积极治疗至少12个月（声带完全切除不受此时间限制），仍无法通过现有医疗手段恢复。精神心理因素所致的语言能力丧失不在保障范围内。申请理赔时被保险人年龄必须在3周岁以上，并且提供理赔当时的语言能力丧失诊断及检查证明。
24.重型再生障碍性贫血	指因骨髓造血功能慢性持续性衰竭导致的贫血、中性粒细胞减少及血小板减少。须满足以下全部条件：（1）骨髓穿刺检查或骨髓活检结果支持诊断；（2）外周血象必须具备以下三项条件：中性粒细胞绝对值0.5109/L；网织红细胞1；血小板绝对值20109/L。
25.主动脉手术	指为治疗主动脉疾病，实际实施了开胸或开腹进行的切除、置换、修补病损主动脉血管的手术。主动脉指胸主动脉和腹主动脉，不包括胸主动脉和腹主动脉的分支血管。动脉内血管成形术不在保障范围内。
26.多发性硬化症	多发性硬化为中枢神经系统白质多灶性脱髓鞘病变，病变有时累及灰质。多发性硬化必须明确诊断，并且已经造成永久不可逆的神经系统功能损害。永久不可逆的神经系统功能损害指被保险人持续180天无法独立完成下列基本日常生活活动：（1）移动：自己从一个房间到另一个房间；或者（2）进食：自己从已准备好的碗或碟中取食物放入口中。
27.胰岛素依赖型糖尿病（1型糖尿病）	是由于胰岛素分泌绝对不足引起的慢性血糖升高，并需持续性地依赖外源性胰岛素维持180天以上，须经血胰岛素测定和血（尿）C肽测定，结果异常，由内分泌科医生确诊，并在本合同有效期内，满足下述至少一个条件：（1）须植入心脏起搏器治疗心脏病；（2）因坏疽需切除一只或以上脚趾。
28.慢性呼吸功能衰竭	慢性肺部疾病导致永久不可逆性的慢性呼吸功能衰竭。慢性呼吸功能衰竭必须明确诊断并满足下列全部条件：（1）休息时出现呼吸困难；（2）动脉血氧分压（PaO2）50mmHg；（3）动脉血氧饱和度（SaO2）80；（4）因缺氧必须接受持续的输氧治疗。
29.植物人状态	一种丧失生理、意识和交流功能后的临床依赖状态。可以是由脑外伤、缺氧持续状态、严重的脑炎或某种神经毒素造成。患者无法从事主动或有目的的活动，而只能对疼痛刺激产生反应。被保险人需要在医院使用辅助机器维持生命。申请理赔需被保险人因植物人状态住院30天以上并且必须有神经专科医生的医学诊断证明。由于酗酒或滥用药物所致的植物人状态不在保障范围内。
30.严重心肌病	指不明原因引起的一类心肌病变，包括原发性扩张型心肌病、原发性肥厚型心肌病及原发性限制型心肌病三种，本病须经专科医生明确诊断，且病变必须已造成事实上心室功能障碍而出现明显的心功能衰竭（达到美国纽约心脏病学会心功能状态分级级，且满足以下全部条件：有医院的医疗记录显示病人不能进行任何活动，休息时仍有心悸、呼吸困难等心力衰竭表现），且有相关住院医疗记录显示级心功能衰竭状态持续至少180天。继发于全身性疾病或其它器官系统疾病造成的心肌病变不在保障范围内。
31.重症肌无力	重症肌无力是一种神经肌肉接头传递障碍所致的疾病，表现为局部或全身骨骼肌（特别是眼外肌）极易疲劳。疾病可以累及呼吸肌、上肢或下肢的近端肌群或全身肌肉，必须满足下列全部条件：（1）经药物治疗和胸腺切除治疗一年以上仍无法控制病情；（2）自主生活能力完全丧失，无法独立完成六项基本日常生活活动中的三项或三项以上。
32.因职业关系导致的人类免疫缺陷病毒（HIV）感染	被保险人在其常规职业工作过程中遭遇外伤，或职业需要处理血液或其它体液时感染上人类免疫缺陷病毒（HIV）。必须满足下列全部条件：（1）感染必须是在被保险人正在从事其职业工作中发生，该职业必须属于下列限定职业范围内的职业；（2）血清转化必须出现在事故发生后的6个月以内；（3）必须提供被保险人在所报事故发生后的5天以内进行的检查报告，该报告必须显示被保险人血液人类免疫缺陷病毒（HIV）阴性和/或人类免疫缺陷病毒（HIV）抗体阴性；（4）必须在事故发生后的12个月内证实被保险人体内存在人类免疫缺陷病毒（HIV）或人类免疫缺陷病毒（HIV）抗体。限定职业：医生和牙科医生、护士、实验室工作人员、医院护工、医生助理和牙医助理、救护车工作人员、助产士、消防队员、警察、狱警。
33.经输血导致的人类免疫缺陷病毒（HIV）感染	被保险人感染上人类免疫缺陷病毒（HIV）并且满足下列全部条件：（1）被保险人因疾病接受输血治疗而感染人类免疫缺陷病毒（HIV）；（2）提供输血治疗的输血中心或医院出具该项输血感染属医疗责任事故的报告，或经法院终审判决为医疗责任；（3）受感染的被保险人不是血友病患者。在任何治愈艾滋病（AIDS）或阻止人类免疫缺陷病毒（HIV）作用的疗法被发现以后，或能防止艾滋病（AIDS）发生的医疗方法被研究出来以后，本保障将不再予以赔付。任何因其它传播方式（包括：性传播或静脉注射毒品）导致的人类免疫缺陷病毒（HIV）感染不在保障范围内。我们必须拥有获得使用被保险人的所有血液样本的权利和能够对这些样本进行独立检验的权利。
34.严重类风湿性关节炎	类风湿性关节炎为广泛分布的慢性进行性多关节病变，表现为关节严重变形，侵犯至少三个主要关节或关节组如：双手（多手指）关节、双足（多足趾）关节、双腕关节、双膝关节和双髋关节。类风湿性关节炎必须明确诊断并且已经达到类风湿性关节炎功能分类级的永久不可逆性关节功能障碍（生活不能自理，且丧失工作能力）并且满足下列全部条件：（1）晨僵；（2）对称性关节炎；（3）类风湿性皮下结节；（4）类风湿因子滴度升高；（5）X线显示严重的关节（软骨和骨）破坏和关节畸形。系统性红斑狼疮是由多种因素引起，累及多系统的自身免疫性疾病。其特
型或以	
35.系统性红斑狼疮上狼疮性肾炎	系统性红斑狼疮是由多种因素引起，累及多系统的自身免疫性疾病。其特点是生成自身抗体对抗多种自身抗原。多见于育龄妇女。本合同所指的系统性红斑狼疮仅限于累及肾脏（经肾脏活检确认的，符合WHO诊断标准定义型或型以上狼疮性肾炎）的系统性红斑狼疮。其它类型的红斑性狼疮，如盘状狼疮、仅累及血液及关节的狼疮不在保障范围内。世界卫生组织（WHO）狼疮性肾炎分型：型微小病变型型系膜病变型型局灶及节段增生型型弥漫增生型型膜型型肾小球硬化型
36.严重克隆病	克隆病是一种慢性肉芽肿性肠炎，具有特征性的克隆病病理组织学变化。诊断必须由病理检查结果证实。被保险人所患的克隆病必须已经造成瘘管形成并伴有肠梗阻或肠穿孔。
37.严重溃疡性结肠炎	本合同所保障的溃疡性结肠炎是指伴有致命性电解质紊乱的急性暴发性溃疡性结肠炎，病变累及全结肠，表现为严重的血便和系统性症状体征，治疗通常采取全结肠切除和回肠造瘘术。溃疡性结肠炎必须根据组织病理学特点诊断，并且被保险人已经接受了结肠切除和回肠造瘘术。
38.非阿尔茨海默病所致严重痴呆	指因阿尔茨海默病以外的脑的器质性疾病造成脑功能衰竭导致永久不可逆性的严重痴呆，临床表现为明显的认知能力障碍、行为异常和社交能力减退。被保险人自主生活能力完全丧失，无法独立完成六项基本日常生活活动中的三项或三项以上，日常生活必须持续受到他人监护。导致痴呆的疾病必须明确诊断，并且由完整的临床、实验室和影像学检查结果证实。神经官能症,精神疾病及酒精中毒所致脑损害不在保障范围内。
39.严重哮喘	严重哮喘必须明确诊断，并且满足下列标准中的三项或三项以上：（1）过去两年中有哮喘持续状态病史；（2）身体活动耐受能力显著且持续下降；（3）慢性肺部过度膨胀充气导致的胸廓畸形；（4）持续每日口服皮质类固醇激素（至少持续六个月以上）。
40.严重脊髓灰质炎	脊髓灰质炎是由于脊髓灰质炎病毒感染所致的瘫痪性疾病，临床表现为运动功能损害或呼吸无力。脊髓灰质炎必须明确诊断。本合同仅对脊髓灰质炎造成的神经系统功能损害导致被保险人一肢或一肢以上肢体机能永久完全丧失的情况予以理赔。肢体机能永久完全丧失，指疾病确诊180天后，每肢三大关节中的两大关节仍然完全僵硬，或不能随意识活动。
41.重症急性坏死性筋膜炎	是一种由细菌侵入皮下组织和筋膜引起的急性坏死性软组织感染，可伴有毒血症、败血症、中毒性休克、弥漫性血管内凝血及多器官衰竭。必须满足以下所有条件：（1）细菌培养和临床表现符合坏死性筋膜炎诊断标准；（2）病情迅速恶化，有脓毒血症表现；（3）受感染肢体被截肢（自腕关节或踝关节近端）。
42.严重川崎病	川崎病为一种病因不明的系统性血管炎。本合同仅对诊断性检查证实川崎病并发冠状动脉瘤或其他心血管异常并且实际接受了手术治疗的情况予以理赔。
43.系统性硬皮病	指一种以局限性或弥漫性皮肤增厚和皮肤、血管、内脏器官异常纤维化为特征的结缔组织病。本病须经专科医师明确诊断，并须满足下列至少一项条件：（1）肺脏：肺部病变进而发展为肺间质纤维化和肺动脉高压；（2）心脏：心功能受损达到美国纽约心脏病学会心功能状态分级级，且有医院的医疗记录显示病人不能进行任何活动，同时休息时仍有心悸、呼吸困难等心力衰竭表现；（3）肾脏：肾脏受损导致双肾功能慢性不可逆衰竭，达到尿毒症期。
44.丝虫病所致象皮肿	指因丝虫感染导致淋巴阻塞出现严重淋巴水肿，达到国际淋巴学会淋巴水肿分期第期，临床表现为肢体象皮肿，患肢较健肢增粗30以上，日常生活不能自理。
45.胰腺移植	指因胰腺功能衰竭，已经实施了在全身麻醉下进行的胰腺的异体器官移植手术（供体必须是人体器官）。单纯胰岛移植、部分胰腺组织或细胞的移植不在保障范围内。
46.急性坏死性胰腺炎开腹手术	指为治疗急性坏死性胰腺炎，实际实施了开腹进行的坏死组织清除术、病灶切除术或胰腺部分切除术。为治疗因酒精中毒引起的急性坏死性胰腺炎的开腹手术不在保障范围内。
47.慢性复发性胰腺炎	指有腹痛等典型症状的胰腺炎反复发作，导致胰腺进行性破坏，并导致胰腺功能紊乱而导致严重糖尿病以及营养不良、恶液质。断层扫描（CT）检查证实胰腺存在广泛钙化，且必须接受酶替代以及胰岛素替代治疗6个月以上。诊断必须由消化科专科医生确诊。酒精导致的慢性复发性胰腺炎不在保障范围内。
48.疯牛病	一种由动物传染而来的中枢神经系统变性疾病，大脑呈海绵状改变伴神经元缺失和胶质化。临床表现为进行性痴呆、不随意运动及抽搐、行动困难等。疯牛病必须由权威医疗机构根据致病蛋白的发现而明确诊断。疑似诊断不作为理赔依据。
49.肾髓质囊性病	肾髓质囊性病的诊断须同时符合下列要求：（1）肾髓质有囊肿、肾小管萎缩及间质纤维化等病理改变；（2）肾功能衰竭；（3）诊断须由肾组织活检确定。
50.原发性硬化性胆管炎	指一种胆汁淤积综合征，其特征是肝内、肝外胆道因纤维化性炎症逐渐狭窄，并最终导致完全阻塞而发展为肝硬化。本病须经内镜逆行胰胆管造影等影像学检查证实，并须满足下列全部条件：（1）总胆红素和直接胆红素同时升高，血清碱性磷酸酶（ALP）200U/L；（2）持续性黄疸病史；（3）出现胆汁性肝硬化或门脉高压。因肿瘤或胆管损伤等继发性的硬化性胆管炎不在保障范围内。
51.嗜铬细胞瘤	指肾上腺或者肾上腺外嗜铬组织出现神经内分泌肿瘤，并分泌过多的儿茶酚胺类，需要确实进行手术以切除肿瘤。
52.侵蚀性葡萄胎（或者称恶性葡萄胎）	指异常增生的绒毛组织浸润性生长侵入子宫肌层或者转移至其它器官或者组织的葡萄胎，并已经进行化疗或者手术治疗。
53.特发性慢性肾上腺皮质功能减退	指自身免疫性肾上腺炎（既往称：特发性肾上腺皮质萎缩）导致肾上腺萎缩和慢性肾上腺皮质功能减退。必须由内分泌专科医生确诊，并且必须满足下列全部条件：（1）明确诊断，符合所有以下诊断标准：血浆促肾上腺皮质激素（ACTH）水平测定大于100pg/ml；血浆和尿游离皮质醇、尿17羟皮质类固醇、尿17酮皮质类固醇、血浆肾素活性、血管紧张素和醛固酮的测定，显示为原发性肾上腺皮质功能减退症；促肾上腺皮质激素（ACTH）刺激试验显示为原发性肾上腺皮质功能减退症。（2）已经采用皮质类固醇替代治疗180天以上。其它任何原因导致的继发性肾上腺皮质功能减退不在保障范围内。
54.重症骨髓增生异常综合征	骨髓增生异常综合征是起源于造血干细胞的一组骨髓克隆增生异常的疾病，表现为无效造血、难治性血细胞减少，有转化为急性髓系白血病的风险。被保险人根据外周血和骨髓活检被血液科专科医生明确诊断为骨髓增生异常综合征，并且满足以下所有条件：（1）FAB分类为难治性贫血伴原始细胞增多（RAEB）；（2）根据骨髓增生异常综合征修订国际预后积分系统（IPSSR）积分3，属于中危及以上组。
55.自体造血干细胞移植	指由于患者自身骨髓造血功能异常或为了达到治疗肿瘤的目的，采集患者自己的一部分造血干细胞，分离并深低温保存，再回输给患者使患者的造血功能和免疫功能重新恢复的一种治疗方法。该治疗须由血液科专科医生认为在临床上是必需的，并且已经实际实施了此项治疗。
56.小肠移植	指因肠道疾病或外伤，已经实施了在全身麻醉下进行的小肠的异体器官移植手术。此手术必须由专科医生认为是医学上必需的情况下进行。
57.肺泡蛋白质沉积症	指肺泡和细支气管腔内充满不可溶性富磷脂蛋白的疾病，胸部X线呈双肺弥漫性肺部磨玻璃影，病理学检查肺泡内充满有过碘酸雪夫（PAS）染色阳性的蛋白样物质，本病必须由专科医生确诊，并且已经接受了肺灌洗治疗。
58.肺淋巴管肌瘤病	肺淋巴管肌瘤病是一种弥漫性肺部疾病，主要病理改变为肺间质、支气管、血管和淋巴管内出现未成熟的平滑肌异常增生，本病必须由专科医生确诊，并且同时须满足下列全部条件：（1）经组织病理学诊断；（2）断层扫描（CT）显示双肺弥漫性囊性改变；（3）血气分析提示低氧血症。
59.严重心肌炎	指被保险人因严重心肌炎性病变导致心功能损害造成持续的永久不可逆性的心功能衰竭。必须满足所有以下条件：（1）心功能衰竭程度达到美国纽约心脏病学会心功能状态分级级，或左室射血分数低于30；（2）上述情况持续不间断180天以上；（3）被保险人永久不可逆性的体力活动能力受限，不能从事任何体力活动，且休息时仍有心悸、呼吸困难等心力衰竭表现。
60.严重肺源性心脏病	指由于各种胸肺及支气管病变而导致继发性肺动脉压力持续增高，导致右心室肥厚，已经造成永久不可逆性的体力活动能力受限，达到美国纽约心脏病学会心功能状态分级级，且满足以下全部条件：有医院的医疗记录显示病人不能进行任何活动，休息时仍有心悸、呼吸困难等心力衰竭表现。本病必须由呼吸科或者心脏专科的专科医生确诊，并且心导管检查显示静息状态下肺动脉平均压超过40mmHg。所有原发性肺动脉高压不在保障范围内。所有先天性心脏疾病直接或间接引起的肺动脉高压也不在保障范围内。
61.夹层主动脉瘤	指主动脉腔内的血流通过主动脉内膜的破裂口进入主动脉内壁而形成血肿。被保险人需通过断层扫描（CT）、核磁共振检查（MRI）、磁共振血管检验法（MRA）或血管扫描等检查，由专科医生确诊，并且已经实施了胸腹切开的直视主动脉手术。
62.严重慢性缩窄型心包炎	由于慢性心包炎症导致心包脏层和壁层广泛瘢痕粘连、增厚和钙化，心包腔闭塞，形成一个纤维瘢痕外壳，使心脏和大血管根部受压，阻碍心脏的舒张。被保险人被专科医生明确诊断为慢性缩窄型心包炎且必须满足以下所有条件：（1）心功能衰竭达到美国纽约心脏病学会心功能状态分级级，且满足以下全部条件：有医院的医疗记录显示病人不能进行任何活动，休息时仍有心悸、呼吸困难等心力衰竭表现，并持续180天以上；（2）实际接受了以下任何一种手术路径的心包剥脱或心包切除手术：胸骨正中切口、双侧前胸切口或左前胸肋间切口。经胸腔镜、胸壁打孔进行的手术、心包粘连松解手术不在保障范围内。
63.严重传染性心内膜炎	指因感染性微生物造成心脏内膜发炎，经由专科医生确诊，并符合下列所有条件:（1）以下方法之一血液培养测试结果为阳性，证实存在感染性微生物：微生物：在赘生物或心脏内脓疡经培养或组织检查证实有微生物；病理性病灶：组织检查证实赘生物或心脏内脓疡有活动性心内膜炎；分别两次血液培养证实有微生物，且与心内膜炎符合；（2）心功能衰竭程度达到美国纽约心脏病学会心功能状态分级级，且满足以下全部条件：有医院的医疗记录显示病人不能进行任何活动，休息时仍有心悸、呼吸困难等心力衰竭表现。
64.严重肠道疾病并发症	因严重肠道疾病或外伤导致小肠损害，并且必须同时满足以下所有条件：（1）至少切除了三分之二长度的小肠；（2）施行完全肠外营养支持的治疗超过90天。
65.严重自身免疫性肝炎	自身免疫性肝炎是一种原因不明的慢性肝脏的坏死性炎性疾病，机体免疫机制被破坏，产生针对肝脏自身抗原的抗体导致自身免疫反应，从而破坏肝细胞造成肝脏炎症坏死，进而发展为肝硬化。必须满足所有以下条件：（1）高球蛋白血症；（2）血液中存在高水平的自身免疫抗体，如抗核抗体（ANA）、抗平滑肌抗体（SMA）、抗肝肾微粒体1抗体（抗LKM1抗体）或抗可溶性肝抗原抗体（抗SLA/LP抗体）；（3）肝脏活检证实免疫性肝炎；（4）临床已经出现腹水、食道静脉曲张和脾肿大等肝硬化表现。
66.颅脑手术	被保险人已实施全麻下的开颅手术（不包括颅骨钻孔手术和经鼻蝶窦入颅手术）。因外伤而实施的脑外科手术不在保障范围内。理赔时必须提供由神经外科专科医生出具的诊断书及手术报告。
67.进行性核上性麻痹	指一种隐袭起病、逐渐加重的神经系统变性疾病，必须由神经内科专科医生确诊，且满足下列全部临床特征：（1）步态共济失调；（2）对称性眼球垂直运动障碍；（3）假性球麻痹（构音障碍和吞咽困难）。
68.婴儿进行性脊肌萎缩症	该病是累及脊髓前角细胞及延髓运动核的神经元退行性变性病，在出生后两年内出现的脊髓和脑干颅神经前角细胞进行性机能障碍，伴随肌肉无力和延髓机能障碍。该病必须经由神经科专科医师通过肌肉活检而确诊，理赔时必须提供肌肉活检的病理报告。其它类型的脊肌萎缩症如型中间型进行性脊肌萎缩症，型少年型脊肌萎缩症(KugelbergWelander氏病)不在保障范围内。
69.疾病或外伤所致智力障碍	因严重头部创伤或疾病造成被保险人智力低下或智力残疾。根据智商（IQ）智力低下分为轻度（IQ5069)、中度（IQ3549）、重度（IQ2034）和极重度（IQ20）。智商的检测须由医院的儿科或成人精神卫生科、心理科或神经科专科医生进行。根据被保险人年龄采用对应的智力量表如韦克斯勒智力量表（儿童智力量表或成人智力量表）。理赔时必须满足下列全部条件：（1）造成被保险人智力低下或智力残疾的严重头部创伤或疾病（以诊断日期为准）发生在被保险人六周岁以后；（2）医院的专科医生确诊被保险人由于严重头部创伤或疾病造成智力低下或智力残疾；（3）医院的儿科或成人精神卫生科、心理科或神经科专科医生做的检测证实被保险人智力低下或智力残疾（轻度、中度、重度或极重度）；（4）被保险人的智力低下或智力残疾自确诊日起持续180天以上。
70.严重肌营养不良症	指一组遗传性肌肉变性病变，临床特征为与神经系统无关的骨骼肌肉对称地进行性无力和萎缩。此症必须由神经内科专科医生明确诊断，并且需满足下列全部条件：（1）肌电图显示典型肌营养不良症的阳性改变；（2）肌肉活检的病理学诊断符合肌营养不良症的肌肉细胞变性、坏死等阳性改变；（3）已导致被保险人持续超过三个月无法独立完成六项基本日常生活活动中的三项或三项以上。
71.严重面部烧伤	指面部烧伤程度为度，且度烧伤的面积达到面部表面积的80或者80以上。体表面积根据中国新九分法计算。
72.失去一肢及一眼	因疾病或者意外伤害导致单眼视力丧失及任何一肢自腕关节或者踝关节近端（靠近躯干端）以上完全性断离。单眼视力丧失指单眼视力永久不可逆性丧失，患眼须满足下列至少一项条件：（1）眼球缺失或者摘除；（2）矫正视力低于0.02（采用国际标准视力表，如果使用其它视力表应进行换算）；（3）视野半径小于5度。被保险人在3周岁之前因疾病导致单眼视力丧失不在保障范围内。
73.溶血性链球菌引起的坏疽	指包围肢体或者躯干的浅筋膜或者深筋膜受到溶血性链球菌的感染，病情在短时间内急剧恶化，且已经立刻进行了手术及清创术。最后的诊断必须由微生物或者病理学专科医生进行相关检查后证实。
74.严重瑞氏综合征	瑞氏综合征是线粒体功能障碍性疾病。导致脂肪代谢障碍，引起短链脂肪酸、血氨升高，造成脑水肿。主要临床表现为急性发热、反复呕吐、惊厥及意识障碍等。肝脏活检是确诊的重要手段。此症必须由医院的儿科专科医生确诊，并符合下列所有条件：（1）有脑水肿和颅内压升高的脑脊液检查和影像学检查证据；（2）血氨超过正常值的3倍；（3）临床出现昏迷，病程至少达到疾病分期第期。
75.埃博拉病毒感染	受埃博拉病毒感染导致出血性发热。埃博拉病必须经传染病专科医生确诊，并且埃博拉病毒的存在必须经过实验室检查证实。该病必须从症状开始三十天后持续出现并发症。
76.肝豆状核变性	由于先天性铜代谢障碍所引起的一种疾病，其特点为肝硬化与双侧脑基底神经节变性同时存在。须经专科医生确认并同时具备下列情况：（1）临床表现包括：进行性加剧的肢体震颤、肌强直、吞咽及发音困难、精神异常；（2）角膜色素环（KF环）；（3）血清铜和血清铜蓝蛋白降低，尿铜增加；（4）食管静脉曲张；（5）腹水。
77.严重原发性骨髓纤维化	原发性骨髓纤维化为原因不明的骨髓中成纤维细胞增殖，伴有髓外造血，表现为进行性贫血、脾肿大等症状。本病必须根据骨髓的活组织检查和周围血象检查由血液科专科医生明确诊断，至少符合下列条件中的三项，且符合条件的状态持续180天及以上，并已经实际接受了针对此症的治疗：（1）血红蛋白绝对值100g/L；（2）白细胞绝对值25109/L；（3）外周血原始细胞1；（4）血小板绝对值100109/L。任何其它病因导致的继发性骨髓纤维化不在保障范围内。
78.严重结核性脑膜炎	由结核杆菌引起的脑膜和脊膜的非化脓性炎症性疾病。需满足以下全部条件：（1）出现颅内压明显增高，表现为头痛、呕吐和视乳头水肿；（2）出现部分性、全身性癫痫发作或癫痫持续状态；（3）昏睡或意识模糊；（4）视力减退、复视和面神经麻痹。
79.出血性登革热	指因出血性登革热出现全部四种症状，包括高烧、出血现象、肝肿大和循环衰竭（登革热休克综合征，即符合世界卫生组织(WHO)登革热第级及第级）。出血性登革热的诊断必须由医院的专科医生确诊。非出血性登革热不在保障范围内。
80.器官移植导致的HIV感染	指因进行器官移植而感染上人类免疫缺陷病毒（HIV），且须满足下列全部条件：（1）在本合同生效日之后，被保险人因治疗必需而实施器官移植，并且因器官移植而感染人类免疫缺陷病毒；（2）提供器官移植治疗的器官移植中心或医院出具的此次因器官移植感染人类免疫缺陷病毒属于医疗事故的报告，或者法院终审裁定为医疗事故并且不准上诉；（3）提供器官移植治疗的器官移植中心或医院必须拥有合法经营执照。任何因其它传播方式（包括：性传播或静脉注射毒品）导致的HIV感染不在保障范围内。
